1 1 2 3 5 8 13 21
1 0 0 0 0 0 0 21
1 0 0 0 0 0 0 13
2 0 0 0 0 0 0 8
3 0 0 0 0 0 0 5
5 0 0 0 0 0 0 3
8 0 0 0 0 0 0 2
13 0 0 0 0 0 0 1
21 0 0 0 0 0 0 1